22
9
3 2 3 2 3 2 3 2 3 2 3 2 3 2 3 2 3 2 3 2 3 2 
2 1 1 1 1 1 1 1 1 1 1 1 1 1 1 0 0 0 0 0 0 3 
3 1 1 1 1 1 1 1 1 1 1 1 1 1 1 0 0 0 0 0 0 2 
2 1 1 1 1 1 1 1 1 1 1 1 1 1 1 0 0 0 0 0 0 3 
3 1 1 1 1 1 1 1 1 1 1 1 1 1 1 0 0 0 0 0 0 2 
2 1 1 1 1 1 1 1 1 1 1 1 1 1 1 0 0 0 0 0 0 3 
3 1 1 1 1 1 1 1 1 1 1 1 1 1 1 0 0 0 0 0 0 2 
2 1 1 1 1 1 1 1 1 1 1 1 1 1 1 0 0 0 0 0 0 3 
3 2 3 2 3 2 3 2 3 2 3 2 3 2 3 2 3 2 3 2 3 2 
